11111111111111
1CCCPCCCC0CCE1
11111111111111