11111111111111
1CCCPCCCC0ECC1
11111111111111